1111111111111111111111111
1010100000101010101000001
1010111110101010101110101
1010000000001000101000101
1011101110101110101011101
1010001000101010001000101
1010111111101011101011111
1010000000100000100000101
1011111010111011111011101
1000100010101010001000101
1011111110101110111011101
1000100000001000000000001
1110101110101110111011101
1000000010100000101010001
1010111110111111101010111
1010100000000010101010101
1111101011101110101110101
1000001000100010000000001
1111111111111111111111111