1111111111111111111111111
1000001000001000001000001
1110101011111110111010111
1010101000000000100010001
1010101011111111101011111
1000100010100000101000101
1110101010101110101111101
1010101000001000100010001
1011111011101010101111101
1010100010001010100010001
1010111110111010101110101
1010000010101010000010101
1010111111101011111011101
1000100010001010100000001
1110101111101110101111101
1010000000100000000010101
1011101110111011101110101
1000001000000010000000101
1111111111111111111111111