1111111111111111111111111
1000000000000000100000101
1111101110101111101011101
1010000010100000101000001
1010111011101111101011101
1000001010101010001000101
1010111010101010111011111
1010100010100010001010001
1010111010111111101110111
1010001000001000100000001
1111101110111110101010101
1000001000100000001010101
1011101011111110111011101
1010001000001000001010001
1111111010111110111111101
1010000010100010100000101
1010101110111010111110101
1000100010000000000000101
1111111111111111111111111